2 2 2 2 2 2 2 2 2 2 2 2 2 2 2 2 2 2 2 2 2 1
1 0 0 0 0 0 0 0 0 0 0 0 0 0 1 6 6 6 6 6 6 4
1 0 0 0 0 0 0 0 4 4 0 0 0 0 1 6 0 0 0 0 6 4
1 0 0 0 0 0 0 0 4 4 0 0 0 0 1 6 0 0 0 0 6 4
1 0 0 0 0 0 0 0 0 0 0 0 0 0 1 6 0 0 0 0 6 4
1 0 0 0 0 0 0 0 0 0 0 0 0 0 1 6 0 0 0 0 6 4
1 0 2 2 2 0 0 0 0 0 0 0 0 0 1 6 0 0 0 0 6 4
1 0 2 2 2 0 0 0 0 0 6 0 0 0 8 8 0 0 1 0 6 4
1 0 2 2 2 0 0 0 0 0 0 0 0 0 1 6 0 0 0 0 6 4
1 0 0 0 0 0 0 0 0 0 0 0 0 0 1 6 0 0 0 0 6 4
1 0 0 0 0 0 0 0 0 0 0 0 0 0 1 6 0 0 0 0 6 4
1 0 0 0 0 0 0 0 0 0 0 0 0 0 1 6 0 0 0 0 6 4
1 0 0 0 0 0 0 0 0 7 7 0 0 0 1 6 1 0 0 0 6 4
1 0 0 0 0 0 0 0 0 7 7 0 0 0 1 6 0 0 0 0 6 4
1 0 0 0 0 0 0 0 0 0 0 0 0 0 1 6 8 6 6 6 6 4
1 8 5 5 5 5 5 5 5 5 5 5 5 5 5 5 8 5 5 5 5 4
1 0 0 0 0 0 0 0 0 0 0 0 0 0 0 0 0 0 0 0 0 4
1 0 1 0 1 0 1 0 1 0 1 0 1 0 1 0 1 0 1 0 0 4
1 0 0 0 0 0 0 0 0 0 0 0 0 0 0 0 0 0 0 0 0 4
1 0 1 0 1 0 1 0 1 0 1 0 1 0 1 0 1 0 1 0 0 4
1 0 0 0 0 0 0 0 0 0 0 0 0 0 0 0 0 0 0 0 0 4
1 0 1 0 1 0 1 0 1 0 1 0 1 0 1 0 1 0 1 0 0 4
1 0 0 0 0 0 0 0 0 0 0 0 0 0 0 0 0 0 0 0 0 4
1 0 1 0 1 0 1 0 1 0 1 0 1 0 1 0 1 0 1 0 0 4
1 0 0 0 0 0 0 0 0 0 0 0 0 0 0 0 0 0 0 0 0 4
1 0 1 0 1 0 1 0 1 0 1 0 1 0 1 0 1 0 1 0 0 4
1 0 0 0 0 0 0 0 0 0 0 0 0 0 0 0 0 0 0 0 0 4
1 0 1 0 1 0 1 0 1 0 1 0 1 0 1 0 1 0 1 0 0 4
1 0 0 0 0 0 0 0 0 0 0 0 0 0 0 0 0 0 0 0 0 4
1 0 1 0 1 0 1 0 1 0 1 0 1 0 1 0 1 0 1 0 0 4
1 0 0 0 0 0 0 0 0 0 0 0 0 0 0 0 0 0 0 0 0 4
1 0 1 0 1 0 1 0 1 0 1 0 1 0 1 0 1 0 1 0 0 4
1 0 0 0 0 0 0 0 0 0 0 0 0 0 0 0 0 0 0 0 0 4
1 0 1 0 1 0 1 0 1 0 1 0 1 0 1 0 1 0 1 0 0 4
1 0 0 0 0 0 0 0 0 0 0 0 0 0 0 0 0 0 0 0 0 4
1 0 1 0 1 0 1 0 1 0 1 0 1 0 1 0 1 0 1 0 0 4
1 0 0 0 0 0 0 0 0 0 0 0 0 0 0 0 0 0 0 0 0 4
1 0 1 0 1 0 1 0 1 0 1 0 1 0 1 0 1 0 1 0 0 4
1 0 0 0 0 0 0 0 0 0 0 0 0 0 0 0 0 0 0 0 0 4
1 0 1 0 1 0 1 0 1 0 1 0 1 0 1 0 1 0 1 0 0 4
1 0 0 0 0 0 0 0 0 0 0 0 0 0 0 0 0 0 0 0 0 4
1 0 1 0 1 0 1 0 1 0 1 0 1 0 1 0 1 0 1 0 0 4
1 0 0 0 0 0 0 0 0 0 0 0 0 0 0 0 0 0 0 0 0 4
1 0 1 0 1 0 1 0 1 0 1 0 1 0 1 0 1 0 1 0 0 4
1 0 0 0 0 0 0 0 0 0 0 0 0 0 0 0 0 0 0 0 0 4
1 0 1 0 1 0 1 0 1 0 1 0 1 0 1 0 1 0 1 0 0 4
1 0 0 0 0 0 0 0 0 0 0 0 0 0 0 0 0 0 0 0 0 4
1 0 1 0 1 0 1 0 1 0 1 0 1 0 1 0 1 0 1 0 0 4
1 0 0 0 0 0 0 0 0 0 0 0 0 0 1 0 0 0 0 0 0 4
1 1 1 1 1 1 1 1 1 1 1 1 1 1 1 1 1 1 1 1 1 4
